****************
*         *   E*
*    *    *  ***
*    *         *
*    *         *
*    *         *
*S   *         *
****************