****************
*            E*
*    ***********
*    *    *    *
*         *    *
*    * *********
*S   *         *
****************