****************
*              *
*    ****** ****
*E   *    *    *
*             S*
* *  * ***** ***
*    *         *
****************